6,6
######
##---#
#-B-P#
#-#-##
#---!#
######