24,12
########################
######----------------##
##-----BBBBB########--##
##--BB#-----B-!!!!##--##
##----#-BB--PB!!!!----##
##--BB##----##!!!!##--##
##----##----##!-!!##--##
##--BB##BBBB##!-!!##--##
##----##--!!B---!!##--##
##--BB##BB!!########--##
##--------------------##
########################