6,6
###X##
#P-2##
###B##
###--#
#!--1Y
######