6,6
##X###
#P2#-#
#-B--#
Y1---#
##-#!#
######