6,6
######
#X2--#
#-B-P#
#-#-##
Y1--!#
######