30,10
##############################
#-P------#####################
###---B--#########--##--######
###------#####--#########--###
###------######--######--#####
###------########------#######
###--B---#####################
###------#####################
###-----------------------!!-#
##############################