30,10
#####X########################
#-P--2---#####################
###---B--#########--##--######
###------#####--#########--###
###------######--######--#####
###------########------#######
###--B---#####################
###------#####################
###--------------------1--!!-#
#######################Y######