24,12
########################
######----------------##
##----BBBBBB########--##
##--BB#-----B-!!!!##--##
##----#-BB--PB!!!!----##
##--BB##----##!!!!##--##
##----##----##!-!!##--##
##--BB##BBBB##!-!!##--##
##----##!!!!B-!-!!##--##
##--BB##BB!!########--##
##--------------------##
########################