6,6
######
#P--##
###B##
###--#
#!---#
######