9,9
#########
#---P---#
#-#-#-#-#
#-B-#-B-#
#-#-#-#-#
#-!-#-#-#
#-----#-#
#-----!-#
#########