8,8
########
#P-----#
#-####-#
#-#!##-#
#-#-!--#
#-B--B-#
#--##--#
########